%%%%%%%%%%%%%%%%%%%%%%%%%%%%%%%%%%%%%%%%%%%%%%%%%%%%%%%%%%%%%%%%%%%%%%%%%%%%%%%%%
% %           %                       %   %     %       %   %               %  .%
% % %%% %%% %%% %% %%%%%%%%%% %%%%%%% %%% % %%% % % %%% % % % %%%%% %%% %%%%% % %
%   %     %   % %   %       %   %   %   % % %   % % %     % %     % % % %     % %
% %%%%    %%% % %%% % % %%% %%% % % %%% % % % %%% % %%%%% % %     % % % % %%% % %
%         %   %   %   % % % %   % %       %     %       % % % %   % %   % %   % %
%%% %% %% % %%%%% % %%% % % %  %% % %%%% %% %%% % %%%%% % % % % %%% % %%% % %%% %
%       % % %   % % % % %   %     % %       % %   %   %   %     %   % %   % % % %
% %%%%%%% % % % %   % % %%% % %%%%% % %%%  %% %%%%%%% %%%%%%% %%% %%% %%%%% % % %
%     %   %   %   % % %   %   %           %     %   %   %         %   %   % % % %
%%%%% % %%%%%   %%% % %%% % %%% %%%     % % %%% % % %%% % %%%%%%% %%% %%% % % % %
%         %     %   % %   % %   %   %   %   %     %     %   %   % %     % % %   %
% %%%%%%% % %%%%% %%% % %%% % %%%%%%% %%%%%%%%%%% %%% %%% % % % %%% % %%% % % %%%
%       % %           % %   %         %         % %   %   % % % %   %     % %   %
%%% % %%% %%%%% %%%%%%% %%% %    %% %%% %%%%% % %%% % %       % % %%%% %%%% %%% %
%   %   %     %   %   %       %         %       %   %   % %   %           % %   %
% % %%% %%%%% % %%% % %%%%% % % %%%   %%% %%      % %%%%% %% %%%%%%%%%% %%% % %%%
% %         % % %   % %   % % %       %   %       % %   %         %     %   % % %
% % %%% %%%%% % % %%% % % %%% %%   %  %%% % %%% % %%% % %%%%%%%        %% %%% % %
%   %   %   % %     % %     %           % %   % % %   %     %     %     %   % % %
% % %%%%% % % % %%% % % %%% %%% % %%    % %%%%% %%% %%% %%% % %%%%% %%% %%% % % %
% %       % % %   % %   % %     % %     %     %           % %       % %   % %   %
% %%% % %%% % %%% % %  %% %%% %%% % %% %%%% % %%%%% %     % %   %% %% %%% % %%% %
% %   % % %   % % %     %   % %   % %       %     % %     %   % %     %   %     %
%   % % % %   % % %     % % % %%% % % %%%%% %%%%% % % %%%%% % % % %%% % %%% % %%%
%   % %     %     %     % %   %   % % %     %     % % %     %   %       %   % % %
%%% %%%% %% % %  %% %% %% % %%% % % % % %%% % %%%%% % % %%%%% %   % % %%% % % % %
%         % % %   % %   %   % % % % % %   % % %     % %   %   %     %   % %     %
%   % %%% % %%% % % % % % %%% % % % % %%% %%% %% %%%% % % % % % %%%%% % %%% %%% %
%P      %       % % % %     %   %   %   %             % %   %         %     %   %
%%%%%%%%%%%%%%%%%%%%%%%%%%%%%%%%%%%%%%%%%%%%%%%%%%%%%%%%%%%%%%%%%%%%%%%%%%%%%%%%%